border_size=1
usage=map

Gg          , Gg          , Gg          , Gg          , Gg          , Gg          , Gg          , Gg          , Gg          , Gg          , Rr          , Gg          , Gg          , Gg          , Gg          , Gg          , Gg          , Gg          , Gg          , Gg          , Gg          , Gg          
Gg          , Gg          , Re          , Gg          , Re          , Gg          , Re          , Gg          , Gg          , Gg          , Re          , Gg          , Ce          , Ce          , Ke          , Ce          , Ce          , 1 Re        , Gg          , Gg          , Gg          , Gg          
Gg          , Gg          , Re          , Re          , Re          , Re          , Re          , Gg          , Gg          , Rd          , Rr          , Re          , Gg          , Ce          , Gg          , Ce          , Re          , Re          , Gg          , Gg          , Gg          , Gg          
Gg          , Gg          , Re          , Re          , Re          , Re          , Re          , Gg          , Gg          , Gg          , Re          , Rr          , Rd          , Gg          , Re          , Re          , Gg          , Gg          , Gg          , Gg          , Gg          , Gg          
Gg          , Gg          , Re          , Re          , Re          , Re          , Re          , Gg          , Gg          , Gg          , Re          , Re          , Gg          , Re          , Gg          , Gg          , Gg          , Gg          , Gg          , Gg          , Gg          , Gg          
Gg          , Gg          , Re          , Re          , Re          , Re          , Rd          , Rd          , Gg          , Rd          , Re          , Rr          , Re          , Re          , Gg          , Gg          , Gg          , Gg          , Gg          , Gg          , Gg          , Gg          
Gg          , Gg          , Gg          , Re          , Gg          , Re          , Ce          , Rd          , Gg          , Gg          , Rr          , Re          , Rd          , Gg          , Gg          , Gg          , Gg          , Gg          , Gg          , Gg          , Gg          , Gg          
Gg          , Gg          , Gg          , Gg          , Gg          , Ce          , 3 Ke        , Ce          , Gg          , Gg          , Re          , Re          , Gg          , Rd          , Rd          , Gg          , Gg          , Gg          , Gg          , Gg          , Gg          , Gg          
Gg          , Gg          , Gg          , Gg          , Gg          , Gg          , Gg          , Gg          , Gg          , Rd          , Rr          , Re          , Gg          , Gg          , Gg          , Gg          , Gg          , Gg          , Gg          , Gg          , Gg          , Gg          
Gg          , Gg          , Rd          , Gg          , Gg          , Gg          , Rd          , Gg          , Gg          , Gg          , Re          , Re          , Rd          , Gg          , Gg          , Gg          , Gg          , Gg          , Gg          , Gg          , Gg          , Gg          
Re          , Re          , Re          , Re          , Re          , Re          , Re          , Rr          , Rr          , Rr          , Re          , Re          , Re          , Rr          , Re          , Rr          , Rr          , Rr          , Re          , Rr          , Re          , Rr          
Rr          , Re          , Re          , Re          , Rr          , Re          , Rr          , Re          , Rr          , Re          , Re          , Re          , Re          , Re          , Rr          , Re          , Re          , Re          , Rr          , Re          , Rr          , Gg          
Gg          , Gg          , Gg          , Gg          , Gg          , Gg          , Gg          , Gg          , Gg          , Rd          , Rr          , Re          , Rd          , Gg          , Gg          , Gg          , Gg          , Gg          , Re          , Gg          , Gg          , Gg          
Gg          , Gg          , Gg          , Gg          , Gg          , Gg          , Ce          , Gg          , Gg          , Gg          , Re          , Re          , Gg          , Gg          , Gg          , Gg          , Re          , Re          , Re          , Gg          , Gg          , Gg          
Gg          , Gg          , Gg          , Gg          , Rd          , Ce          , 2 Ke        , Ce          , Gg          , Rd          , Re          , Re          , Gg          , Gg          , Gg          , Re          , Re          , Re          , Re          , Gg          , Gg          , Gg          
Gg          , Gg          , Gg          , Gg          , Rd          , Rd          , Gg          , Gg          , Gg          , Gg          , Rr          , Rr          , Rd          , Gg          , Gg          , Re          , Re          , Re          , Re          , Gg          , Gg          , Gg          
Gg          , Gg          , Gg          , Gg          , Gg          , Rd          , Gg          , Gg          , Gg          , Gg          , Re          , Re          , Gg          , Gg          , Gg          , Re          , Re          , Re          , Re          , Gg          , Gg          , Gg          
Gg          , Gg          , Gg          , Re          , Re          , Re          , Re          , Gg          , Gg          , Rd          , Re          , Re          , Gg          , Gg          , Gg          , Re          , Ce          , Re          , Gg          , Gg          , Gg          , Gg          
Gg          , Gg          , Gg          , Re          , Re          , Re          , Re          , Gg          , Gg          , Gg          , Rr          , Rr          , Rd          , Gg          , Gg          , Ce          , 4 Ke        , Ce          , Gg          , Gg          , Gg          , Gg          
Gg          , Gg          , Gg          , Re          , Re          , Re          , Re          , Gg          , Gg          , Gg          , Re          , Rr          , Gg          , Gg          , Gg          , Gg          , Gg          , Gg          , Gg          , Gg          , Gg          , Gg          
Gg          , Gg          , Gg          , Re          , Re          , Re          , Re          , Gg          , Gg          , Rd          , Re          , Re          , Gg          , Gg          , Gg          , Gg          , Gg          , Gg          , Gg          , Gg          , Gg          , Gg          
Gg          , Gg          , Gg          , Gg          , Gg          , Gg          , Gg          , Gg          , Gg          , Gg          , Rr          , Rr          , Gg          , Gg          , Gg          , Gg          , Gg          , Gg          , Gg          , Gg          , Gg          , Gg          
