border_size=1
usage=map

Xv          , Xv          , Xv          , Xv          , Xv          , Xv          , Xv          , Xv          , Xv          , Xv          , Xv          , Xv          , Xv          , Xv          , Xv          , Xv          , Xv          , Xv          , Xv          , Xv          , Xv          
Xv          , Rr          , Rr          , Rr          , Rr          , Rr          , Rr          , Rr          , Rr          , Rr          , Rr          , Rr          , Rr          , Rr          , Rr          , Rr          , Rr          , Rr          , Rr          , Rr          , Xv          
Xv          , Rr          , Rr          , Rr          , Rr          , 1 Rr        , Rr          , Rr          , Rr          , Rr          , Rr          , Rr          , Rr          , Rr          , Rr          , Rr          , Rr          , Rr          , Rr          , Rr          , Xv          
Xv          , Rr          , Rr          , Rr          , Rr          , Rr          , Rr          , Rr          , Rr          , Rr          , Rr          , Rr          , Rr          , Rr          , Rr          , Rr          , Rr          , Rr          , Rr          , Rr          , Xv          
Xv          , Rr          , Rr          , Rr          , Rr          , Rr          , Rr          , Rr          , Rr          , Rr          , Rr          , Rr          , Rr          , Rr          , Rr          , Rr          , Rr          , Rr          , Rr          , Rr          , Xv          
Xv          , Rr          , Rr          , Rr          , Rr          , Rr          , Rr          , Rr          , Rr          , Rr          , Rr          , Rr          , Rr          , Rr          , Rr          , Rr          , Rr          , Rr          , Rr          , Rr          , Xv          
Xv          , Rr          , Rr          , Rr          , Rr          , Rr          , Rr          , Xv          , Rr          , Rr          , Rr          , Xv          , Rr          , Rr          , Rr          , Xv          , Rr          , Rr          , Rr          , Rr          , Xv          
Xv          , Rr          , Rr          , Rr          , Rr          , Rr          , Rr          , Xv          , Rr          , Rr          , Rr          , Xv          , Rr          , Rr          , Rr          , Xv          , Rr          , Rr          , Rr          , Rr          , Xv          
Xv          , Rr          , Rr          , Rr          , Rr          , Rr          , Rr          , Xv          , Rr          , Rr          , Rr          , Xv          , Rr          , Rr          , Rr          , Xv          , Rr          , Rr          , Rr          , Rr          , Xv          
Xv          , Rr          , Rr          , Rr          , Rr          , Rr          , Rr          , Xv          , Rr          , Rr          , Rr          , Xv          , Rr          , Rr          , Rr          , Xv          , Rr          , Rr          , Rr          , Rr          , Xv          
Xv          , Rr          , Rr          , Rr          , Rr          , Rr          , Rr          , Xv          , Rr          , Rr          , Rr          , Xv          , Rr          , Rr          , Rr          , Xv          , Rr          , Rr          , Rr          , Rr          , Xv          
Xv          , Rr          , Rr          , Rr          , Rr          , Rr          , Rr          , Xv          , Rr          , Rr          , Rr          , Xv          , Rr          , Rr          , Rr          , Xv          , Rr          , Rr          , Rr          , Rr          , Xv          
Xv          , Rr          , Rr          , Rr          , Rr          , Rr          , Rr          , Rr          , Rr          , Rr          , Rr          , Rr          , Rr          , Rr          , Rr          , Rr          , Rr          , Rr          , Rr          , Rr          , Xv          
Xv          , Rr          , Rr          , Rr          , Rr          , Rr          , Rr          , Rr          , Rr          , Rr          , Rr          , Rr          , Rr          , Rr          , Rr          , Rr          , Rr          , Rr          , Rr          , Rr          , Xv          
Xv          , Xv          , Xv          , Xv          , Xv          , Xv          , Xv          , Xv          , Xv          , Xv          , Xv          , Xv          , Xv          , Xv          , Xv          , Xv          , Xv          , Xv          , Xv          , Xv          , Xv          
