border_size=1
usage=map

Wo          , Wo          , Wo          , Wo          , Wo          , Wo          , Wo          , Wo          , Wo          , Wo          , Wo          , Wo          , Wo          , Wo          , Wo          , Wo          , Wo          , Wo          , Wo          , Wo          , Wo          , Wo          , Wo          , Wo          , Wo          , Wo          , Wo          , Wo          , Wo          , Wo          , Wo          , Wo          , Wo          , Wo          , Wo          , Wo          
Wo          , Wo          , Wo          , Wo          , Wo          , Wo          , Wo          , Wo          , Wo          , Wo          , Wo          , Wo          , Wo          , Wo          , Wo          , Wo          , Wo          , Wo          , Wo          , Wo          , Wo          , Wo          , Wo          , Wo          , Wo          , Wo          , Wo          , Wo          , Wo          , Wo          , Wo          , Wo          , Wo          , Wo          , Wo          , Wo          
Wo          , Wo          , Wo          , Wo          , Wo          , Wo          , Wo          , Wo          , Wo          , Wo          , Wo          , Wo          , Wo          , Wo          , Wo          , Wo          , Wo          , Wo          , Wo          , Wo          , Wo          , Wo          , Wo          , Wo          , Wo          , Wo          , Wo          , Wo          , Wo          , Wo          , Wo          , Wo          , Wo          , Wo          , Wo          , Wo          
Wo          , Wo          , Wo          , Wo          , Ww          , Wo          , Wo          , Wo          , Wo          , Wo          , Wo          , Wo          , Wo          , Wo          , Wo          , Wo          , Wo          , Wo          , Wo          , Ww          , Ww          , Wo          , Wo          , Wo          , Wo          , Wo          , Wo          , Wo          , Ww          , Wo          , Ww          , Wo          , Wo          , Wo          , Wo          , Wo          
Wo          , Wo          , Wo          , Ww          , Ww          , Ww          , Ww          , Ww          , Wo          , Wo          , Wo          , Wo          , Wo          , Wo          , Wo          , Wo          , Wo          , Wo          , Ww          , Ww          , Ww          , Ww          , Ww          , Ww          , Ww          , Ww          , Ww          , Ww          , Ww          , Ww          , Ww          , Wo          , Wo          , Wo          , Wo          , Wo          
Wo          , Wo          , Wo          , Ww          , Ww          , Ww          , Ww          , Ww          , Ww          , Wo          , Wo          , Wo          , Wo          , Wo          , Wo          , Wo          , Ww          , Ww          , Ww          , Ds          , Ds          , Ww          , Ww          , Ww          , Ww          , Ww          , Ww          , Ww          , Ww          , Ww          , Ww          , Ww          , Wo          , Wo          , Wo          , Wo          
Wo          , Wo          , Wo          , Ww          , Ww          , Gs          , Gs          , Ww          , Ww          , Ww          , Wo          , Wo          , Wo          , Wo          , Wo          , Ww          , Ww          , Ww          , Ww          , Ds          , Gs          , Ds          , Ww          , Ww          , Ww          , Ww          , Ww          , Ww          , Ww          , Ww          , Ww          , Ww          , Ww          , Wo          , Wo          , Wo          
Wo          , Wo          , Ww          , Ww          , Gs          , Gs          , Gs          , Ww          , Ww          , Ww          , Wo          , Ww          , Ww          , Ww          , Wo          , Ww          , Ds          , Ds          , Ww          , Gs          , Gs          , Ds          , Ds          , Ww          , Ww          , Ds          , Ds          , Ds          , Ww          , Ww          , Ww^Bw/      , Ww          , Ww          , Wo          , Wo          , Wo          
Wo          , Wo          , Wo          , Ww          , Ww          , Ds          , Gg^Vh       , Gs          , Ww          , Ww          , Ww          , Ww          , Ww          , Ww          , Ww          , Ww          , Ds          , Gg          , Ww          , Gs          , Rd          , Rd          , Ds          , Ds          , Ds          , Ds          , Gs          , Ds          , Ds          , Ds          , Ww          , Ww          , Ww          , Wo          , Wo          , Wo          
Wo          , Wo          , Wo          , Ww          , Ww          , Ds          , Gg          , Gs          , Ww          , Ww          , Ww          , Ww          , Gg          , Gg          , Ww          , Ds          , Gs          , Gs^Vht      , Ww          , Gg          , Rd          , Gs          , Gs          , Ds          , Gs          , Gs          , Gs          , Gs          , Ds          , Ds          , Ww          , Ww          , Wo          , Wo          , Wo          , Wo          
Wo          , Wo          , Ww          , Ww          , Ww          , Ds          , Rd          , Gs          , Ds          , Ww          , Ds          , Gs          , Gs          , Gg          , Ww          , Ds          , Gs          , Ww          , Ww          , Gg          , Gg          , Gs^Vht      , Gs          , Rd          , Rd          , Rd          , Rd          , Gs          , Gs          , Ds          , Ww          , Ww          , Wo          , Wo          , Wo          , Wo          
Wo          , Wo          , Ww          , Ww          , Ds          , Gs          , Rd          , Gs          , Gg          , Ds          , Gs          , Gs^Fp       , Gs          , Gg          , Ww          , Gs          , Gs          , Ww          , Gg          , Gg          , Gs          , Rd          , Rd          , Rd          , Gs          , Gg          , Gs^Fp       , Gs^Fp       , Gs^Fp       , Ds          , Ds          , Ww          , Ww          , Wo          , Wo          , Wo          
Wo          , Wo          , Ww          , Ww          , Ds          , Gs          , Gg          , Gs          , Gs^Vht      , Rd          , Gs          , Gs^Fp       , Gs^Fp       , Gg          , Ww          , Gs          , Ww          , Ww          , Gg          , Gg          , Gs          , Rd          , Gs          , Rd          , Gs          , Gg          , Gg          , Gg          , Gs^Fp       , Gg          , Ds          , Ds          , Ww          , Ww          , Wo          , Wo          
Wo          , Wo          , Ww          , Ww          , Ds          , Gg^Vh       , Gg          , Gg          , Gs          , Rd          , Rd          , Gs          , Gs          , Gg^Vh       , Ww          , Gs          , Ww          , Gg          , Gs          , Gs          , Gs          , Rd          , Gs          , Gs          , Gs^Vht      , Gg          , Gg          , Gg          , Gs^Fp       , Gs          , Ds          , Ds          , Ww          , Ww          , Wo          , Wo          
Wo          , Wo          , Ww          , Ww          , Ww          , Ds          , Gs          , Gs^Fp       , Gs^Fp       , Rd          , Gs          , Rd          , Gs          , Gg          , Ww          , Ww          , Ww          , Gg          , Gg          , Gg          , Rr          , Rr          , Gg          , Gs          , Gs^Fp       , Gg          , Gg          , Gg          , Gs^Fp       , Gs^Fp       , Ds          , Ww          , Ww          , Wo          , Wo          , Wo          
Wo          , Wo          , Wo          , Ww          , Ww          , Ds          , Gg          , Gs          , Gg          , Gs          , Gs^Vht      , Gs          , Gg          , Gg          , Gg          , Ww          , Ww          , Gs          , Gs^Vht      , Rr          , Gg          , Gs          , Gs^Fp       , Gg          , Gs^Fp       , Gs^Fp       , Gs^Fp       , Gg^Vh       , Gs^Fp       , Gs^Fp       , Ds          , Ww          , Ww          , Wo          , Wo          , Wo          
Wo          , Wo          , Wo          , Ww          , Ww          , Ww          , Ds          , Gg          , Rd          , Gg          , Gg          , Gs^Fp       , Gs          , Rd          , Gs^Fp       , Gs^Fp       , Ww          , Gs          , Gs          , Gs          , Gs          , Gg          , Gg^Vh       , Gs^Fp       , Gs^Fp       , Gs^Fp       , Gs^Fp       , Gs^Fp       , Gs^Fp       , Gs^Fp       , Ds          , Ds          , Ww          , Ww          , Wo          , Wo          
Wo          , Wo          , Wo          , Ww          , Ww          , Ds          , Gs^Vht      , Rd          , Gs^Fp       , Gs          , Gg          , Gs          , Gs^Fp       , Gs          , Rr          , Rd          , Ww          , Gs          , Hh          , Hh          , Hh          , Gs          , Gs^Fp       , Gs^Fp       , Gs^Fp       , Gs          , Gs^Fp       , Gs^Fp       , Gs^Fp       , Gs^Fp       , Gg          , Ds          , Ww          , Ww          , Wo          , Wo          
Wo          , Wo          , Ww          , Ww          , Ds          , Gg          , Gs          , Gs          , Gs          , Gs^Fp       , Rd          , Rd          , Rd          , Rr          , Gs^Vht      , Gs          , Ww          , Ww          , Mm          , Mm          , Mm          , Gs^Fp       , Gs^Fp       , Gs^Fp       , Gs^Fp       , Gg^Vh       , Gs^Fp       , Gs^Fp       , Gs^Fp       , Gs^Fp       , Gg          , Ds          , Ds          , Ww          , Wo          , Wo          
Wo          , Wo          , Ww          , Ww          , Ds          , Gg          , Gs          , Gs          , Gs^Fp       , Gs          , Rd          , Gs          , Gs          , Gs          , Gs          , Mm          , Mm          , Ww          , Mm          , Mm          , Mm          , Mm          , Hh          , Gs^Fp       , Gs^Fp       , Gs^Fp       , Gs^Fp       , Gs          , Gg          , Gg          , Ds          , Ds          , Ww          , Ww          , Wo          , Wo          
Wo          , Wo          , Wo          , Ww          , Ww          , Gg^Vh       , Gg          , Gg          , Gs          , Gs          , Rr          , Gg^Vh       , Hh          , Hh          , Mm          , Mm          , Mm          , Ww          , Ww          , Mm          , Mm          , Mm          , Hh          , Gs^Fp       , Gg^Vh       , Gs^Fp       , Gs^Fp       , Gs^Vht      , Gg          , Gg          , Ds          , Ds          , Ww          , Wo          , Wo          , Wo          
Wo          , Wo          , Wo          , Ww          , Ds          , Ds          , Gg          , Gg          , Hh          , Hh          , Rr          , Hh          , Hh          , Hh          , Mm          , Mm          , Ww          , Ww          , Ww          , Ww          , Mm          , Mm          , Gg          , Gg          , Gg          , Gs          , Gg          , Gg          , Gg          , Gg          , Ds          , Ww          , Ww          , Wo          , Wo          , Wo          
Wo          , Wo          , Wo          , Ww          , Ds          , Gg          , Rd          , Rd          , Gg          , Gs          , Rd          , Hh          , Hh          , Hh          , Mm          , Mm          , Ww          , Ww          , Ww          , Ww          , Ww          , Mm          , Mm          , Hh          , Gg          , Gg          , Rd          , Gs          , Gg          , Gs^Fp       , Gg          , Ds          , Ww          , Wo          , Wo          , Wo          
Wo          , Wo          , Wo          , Ww          , Ww          , Ds          , Ds          , Gg          , Gg          , Gs          , Gs          , Hh          , Hh          , Hh          , Mm          , Mm          , Ww          , Ww          , Ww          , Ww          , Ww          , Mm          , Mm          , Hh          , Hh          , Gs          , Rd          , Gs          , Gs          , Gs^Fp       , Gs^Fp       , Ds          , Ww          , Ww          , Wo          , Wo          
Wo          , Wo          , Wo          , Wo          , Ww          , Ww          , Ww          , Ds          , Gg^Vh       , Gg          , Rr          , Gs          , Hh          , Hh          , Hh          , Mm          , Mm          , Ww          , Ww          , Ww          , Ww          , Mm          , Mm          , Mm          , Hh          , Gs          , Gs          , Rd          , Rd          , Gs          , Gs^Fp       , Gg^Vh       , Ds          , Ww          , Wo          , Wo          
Wo          , Wo          , Wo          , Wo          , Ww          , Ww          , Ww          , Ds          , Ds          , Gg          , Rr          , Gs^Vht      , Gs          , Hh          , Hh          , Mm          , Mm          , Ww          , Ww          , Ww          , Mm          , Mm          , Mm          , Hh          , Gg          , Gs          , Rd          , Gs          , Rd          , Rd          , Gs          , Gs^Vht      , Ds          , Ww          , Wo          , Wo          
Wo          , Wo          , Wo          , Wo          , Wo          , Ww          , Ww          , Ww          , Ww          , Ds          , Gg          , Rr          , Rr          , Gs          , Hh          , Mm          , Mm          , Ww          , Ww          , Ww          , Mm          , Mm          , Gg^Vh       , Gg          , Gs          , Rd          , Gs          , Rd          , Gs          , Rd          , Rd          , Ds          , Ds          , Ww          , Wo          , Wo          
Wo          , Wo          , Wo          , Wo          , Wo          , Wo          , Ww          , Ww          , Ww          , Ds          , Gg          , Gs          , Rd          , Gs          , Hh          , Hh          , Mm          , Mm          , Mm          , Mm          , Mm          , Mm          , Gg          , Gg          , Gg          , Gs          , Gs^Vht      , Gs          , Gs          , Rd          , Ds          , Ww          , Ww          , Ww          , Wo          , Wo          
Wo          , Wo          , Wo          , Wo          , Wo          , Wo          , Wo          , Ww          , Ww          , Ds          , Gg          , Gg          , Rr          , Gs          , Gs          , Hh          , Hh          , Mm          , Hh^Vhh      , Mm          , Mm          , Mm          , Gs          , Gg          , Gg          , Gg          , Rd          , Gg          , Gg          , Ds          , Ww          , Ww          , Wo          , Wo          , Wo          , Wo          
Wo          , Wo          , Wo          , Wo          , Wo          , Wo          , Ww          , Ww          , Ww          , Ww          , Ds          , Gg          , Rr          , Gs          , Gg          , Gs          , Hh          , Hh          , Mm          , Mm          , Mm          , Hh          , Gs          , Gg          , Gs          , Gs          , Gs          , Rd          , Rd          , Ds          , Ww          , Wo          , Wo          , Wo          , Wo          , Wo          
Wo          , Wo          , Wo          , Wo          , Ww          , Ww          , Ww          , Ww          , Ww          , Ww          , Ds          , Gs^Vht      , Gs          , Gs          , Gg          , Gg^Vh       , Gs          , Gs          , Hh          , Hh          , Hh          , Gs          , Gg          , Gg          , Gs          , Gs          , Gg          , Gs          , Gg          , Ds          , Ww          , Wo          , Wo          , Wo          , Wo          , Wo          
Wo          , Wo          , Wo          , Wo          , Ww          , Ww          , Ds          , Ds          , Ww          , Ds          , Gg          , Gg          , Rd          , Gg          , Gs          , Gs          , Gs          , Gs          , Gs          , Rd          , Rd          , Rd          , Rd          , Rd          , Rd          , Gg          , Rd          , Gg          , Ds          , Ww          , Ww          , Wo          , Wo          , Wo          , Wo          , Wo          
Wo          , Wo          , Wo          , Ww          , Ds          , Gs          , Gs          , Gs          , Ds          , Ds          , Gg          , Gg          , Rd          , Gs          , Gg          , Gg          , Gs          , Gs          , Gs          , Gs          , Gs          , Gs^Fp       , Gs          , Gs          , Gs          , Rd          , Gs          , Gg          , Gg          , Ds          , Ww          , Ww          , Wo          , Wo          , Wo          , Wo          
Wo          , Wo          , Ww          , Ww          , Gs          , Re          , Re          , Re          , Gg          , Gs          , Rr          , Rd          , Gs          , Gg          , Re          , Gs          , Gs          , Gs^Fp       , Gs^Fp       , Gs^Fp       , Gs^Fp       , Gs^Fp       , Gs^Fp       , Gs^Vht      , Gs          , Rd          , Gg          , 1 Gg^Vh     , Gg          , Gg          , Ds          , Ww          , Ww          , Wo          , Wo          , Wo          
Wo          , Wo          , Ww          , Ww          , Ds          , Gg          , Gg          , Gg          , Gg^Vh       , Gs          , Re          , Gs          , Re          , Gs          , Gs          , Re          , Gs          , Gs^Fp       , Gs^Fp       , Gs^Fp       , Gs^Fp       , Gs^Fp       , Gs^Fp       , Rd          , Rd          , Rd          , Rd          , Rd          , Gg          , Ds          , Ww          , Ww          , Ww          , Wo          , Wo          , Wo          
Wo          , Wo          , Ww          , Ww          , Ds          , Gg          , Gg          , Gg          , Rr          , Re          , Re          , Gs^Vht      , Gs          , Re          , Re          , Re          , Gs          , Gs^Fp       , Gs^Fp       , Gs^Vht      , Gs^Fp       , Gs^Fp       , Gs^Fp       , Gs^Fp       , Gs^Fp       , Rd          , Rd          , Gs          , Gg          , Ds          , Ww          , Wo          , Wo          , Wo          , Wo          , Wo          
Wo          , Wo          , Ww          , Ww          , Ds          , Gg          , Gg          , Gg          , Re          , Re          , Gs          , Gs          , Re          , Gs          , Ww          , Ww          , Gg^Vh       , Gs^Fp       , Gs^Fp       , Gs^Fp       , Gs^Fp       , Gs^Fp       , Gs^Fp       , Rd          , Gs^Fp       , Rd          , Rd          , Gs          , Gs          , Ds          , Ww          , Ww          , Wo          , Wo          , Wo          , Wo          
Wo          , Wo          , Ww          , Gs          , Gs          , Gg^Vh       , Re          , Re          , Gs^Vht      , Re          , Re          , Rr          , Re          , Gs          , Gg          , Ww          , Gs          , Gs^Fp       , Gs^Fp       , Gs^Fp       , Gs^Fp       , Gs^Fp       , Gs^Fp       , Rd          , Rd          , Rd          , Rd          , Rd          , Gs          , Gs          , Ds          , Ww          , Ww          , Wo          , Wo          , Wo          
Wo          , Wo          , Wo          , Ww          , Gs          , Re          , Gs          , Re          , Gs          , Gs          , Gs          , Re          , Gs          , Gs          , Gg          , Ww          , Gs          , Gs^Fp       , Gs^Fp       , Gs^Fp       , Gs^Fp       , Ds          , Ds          , Ds          , Rd          , Rd          , Gs          , Gs          , Gs          , Ds          , Ww          , Ww          , Wo          , Wo          , Wo          , Wo          
Wo          , Wo          , Wo          , Ww          , Ww          , Ds          , Ds          , Ww          , Gs          , Gs          , Gg^Vh       , Gs          , Gg          , Gg          , Gg          , Ww          , Gs          , Gs^Fp       , Gs^Fp       , Gs^Fp       , Ds          , Ds          , Ww          , Ds          , Gs          , Rd          , Gs          , Rd          , Gs          , Ww          , Ww          , Ww          , Wo          , Wo          , Wo          , Wo          
Wo          , Wo          , Wo          , Wo          , Ww          , Ww          , Ww          , Ww          , Ww          , Ww          , Ds          , Gg          , Ds          , Ds          , Ds          , Ww          , Ww          , Gs          , Gs^Fp       , Ds          , Ww          , Ww          , Ww          , Ww          , Ww          , Gs          , Gs          , Ww          , Ww          , Ww          , Ww          , Wo          , Wo          , Wo          , Wo          , Wo          
Wo          , Wo          , Wo          , Wo          , Wo          , Ww          , Ww          , Ww          , Ww          , Ww          , Ww          , Ds          , Ds          , Ww          , Ds          , Ww          , Ww          , Ww          , Gs          , Ww          , Ww          , Ww          , Wo          , Ww          , Ww          , Ww          , Ww          , Ww          , Ww          , Ww          , Wo          , Wo          , Wo          , Wo          , Wo          , Wo          
Wo          , Wo          , Wo          , Wo          , Wo          , Ww          , Ww          , Ww          , Ww          , Ww          , Wo          , Ww          , Ww          , Ww          , Ww          , Ww          , Wo          , Ww          , Ww          , Ww          , Wo          , Wo          , Wo          , Wo          , Wo          , Ww          , Ww          , Ww          , Ww          , Ww          , Ww          , Wo          , Wo          , Wo          , Wo          , Wo          
Wo          , Wo          , Wo          , Wo          , Wo          , Wo          , Wo          , Wo          , Wo          , Wo          , Wo          , Wo          , Wo          , Ww          , Wo          , Wo          , Wo          , Ww          , Ww          , Ww          , Wo          , Wo          , Wo          , Wo          , Wo          , Wo          , Ww          , Ww          , Wo          , Ww          , Wo          , Wo          , Wo          , Wo          , Wo          , Wo          
Wo          , Wo          , Wo          , Wo          , Wo          , Wo          , Wo          , Wo          , Wo          , Wo          , Wo          , Wo          , Wo          , Wo          , Wo          , Wo          , Wo          , Wo          , Wo          , Wo          , Wo          , Wo          , Wo          , Wo          , Wo          , Wo          , Wo          , Wo          , Wo          , Wo          , Wo          , Wo          , Wo          , Wo          , Wo          , Wo          
Wo          , Wo          , Wo          , Wo          , Wo          , Wo          , Wo          , Wo          , Wo          , Wo          , Wo          , Wo          , Wo          , Wo          , Wo          , Wo          , Wo          , Wo          , Wo          , Wo          , Wo          , Wo          , Wo          , Wo          , Wo          , Wo          , Wo          , Wo          , Wo          , Wo          , Wo          , Wo          , Wo          , Wo          , Wo          , Wo          
Wo          , Wo          , Wo          , Wo          , Wo          , Wo          , Wo          , Wo          , Wo          , Wo          , Wo          , Wo          , Wo          , Wo          , Wo          , Wo          , Wo          , Wo          , Wo          , Wo          , Wo          , Wo          , Wo          , Wo          , Wo          , Wo          , Wo          , Wo          , Wo          , Wo          , Wo          , Wo          , Wo          , Wo          , Wo          , Wo          
