border_size=1
usage=map

Xv          , Xv          , Xv          , Xv          , Xv          , Xv          , Xv          , Xv          , Xv          , Xv          , Xv          , Xv          , Xv          , Xv          , Xv          , Xv          , Xv          , Xv          , Xv          , Xv          , Xv          
Xv          , Rd          , Rd          , Rd          , Rd          , Rd          , Rd          , Rd          , Rd          , Rd          , Rd          , Rd          , Rd          , Rd          , Rd          , Rd          , Rd          , Rd          , Rd          , Rd          , Xv          
Xv          , Rd          , Rd          , Rd          , Rd          , Rd          , Rd          , Rd          , Rd          , Rd          , Rd          , Rd          , Rd          , Rd          , Rd          , Rd          , Rd          , Rd          , Rd          , Rd          , Xv          
Xv          , Rd          , Rd          , Rd          , Rd          , Rd          , Rd          , Rd          , Rd          , Rd          , Rd          , Rd          , Rd          , Rd          , Rd          , Rd          , Rd          , Rd          , Rd          , Rd          , Xv          
Xv          , Rd          , Rd          , Rd          , Rd          , Rd          , Rd          , Rd          , Rd          , Rd          , Rd          , Rd          , Rd          , Rd          , Rd          , Rd          , Rd          , Rd          , Rd          , Rd          , Xv          
Xv          , Rd          , Rd          , Rd          , Rd          , Rd          , Rd          , Rd          , Rd          , Rd          , Rd          , Rd          , Rd          , Rd          , Rd          , Rd          , Rd          , Rd          , Rd          , Rd          , Xv          
Xv          , Rd          , Rd          , Xv          , Rd          , Rd          , Rd          , Xv          , Rd          , Rd          , Rd          , Xv          , Rd          , Rd          , Rd          , Xv          , Rd          , Rd          , Rd          , Rd          , Xv          
Xv          , Rd          , 1 Rd        , Xv          , Rd          , Rd          , Rd          , Xv          , Rd          , Rd          , Rd          , Xv          , Rd          , Rd          , Rd          , Xv          , Rd          , Rd          , Rd          , Rd          , Xv          
Xv          , Rd          , Rd          , Xv          , Rd          , Rd          , Rd          , Xv          , Rd          , Rd          , Rd          , Xv          , Rd          , Rd          , Rd          , Xv          , Rd          , Rd          , Rd          , Rd          , Xv          
Xv          , Rd          , Rd          , 2 Rd        , Rd          , Rd          , Rd          , Xv          , Rd          , Rd          , Rd          , Xv          , Rd          , Rd          , Rd          , Xv          , Rd          , Rd          , Rd          , Rd          , Xv          
Xv          , Rd          , Rd          , Rd          , Rd          , Rd          , Rd          , Xv          , Rd          , Rd          , Rd          , Xv          , Rd          , Rd          , Rd          , Xv          , Rd          , Rd          , Rd          , Rd          , Xv          
Xv          , Rd          , Rd          , Rd          , Rd          , Rd          , Rd          , Xv          , Rd          , Rd          , Rd          , Xv          , Rd          , Rd          , Rd          , Xv          , Rd          , Rd          , Rd          , Rd          , Xv          
Xv          , Rd          , Rd          , Rd          , Rd          , Rd          , Rd          , Rd          , Rd          , Rd          , Rd          , Rd          , Rd          , Rd          , Rd          , Rd          , Rd          , Rd          , Rd          , Rd          , Xv          
Xv          , Rd          , Rd          , Rd          , Rd          , Rd          , Rd          , Rd          , Rd          , Rd          , Rd          , Rd          , Rd          , Rd          , Rd          , Rd          , Rd          , Rd          , Rd          , Rd          , Xv          
Xv          , Xv          , Xv          , Xv          , Xv          , Xv          , Xv          , Xv          , Xv          , Xv          , Xv          , Xv          , Xv          , Xv          , Xv          , Xv          , Xv          , Xv          , Xv          , Xv          , Xv          
