border_size=1
usage=map

Ss          , Ss          , Ss          , Ss          , Gg          , Gg          , Gg          , Hh          , Hh          , Gg          , Ss          , Ss          , Gg          , Gg          , Gg          , Ss          , Ss          , Ss          , Gg          , Gg          , Gg          , Gg          , Gg          , Ss          , Ss          , Ss          , Ss          , Ss          
Ss          , Gg          , Ss          , Gg          , Gg          , Gg          , Gg          , Hh          , Hh          , Gg          , Gg          , Gg          , Gg          , Gg          , Gg          , Ss          , Gg          , Gg          , Gs^Fp       , Hh          , Hh          , Gg          , Ss          , Ss          , Ss          , Ss          , Gg          , Gg          
Ss          , Gg          , Gg          , Gg          , Gg          , Gg          , Gg          , Gg          , Gs^Fp       , Gs^Fp       , Gg          , Gg          , Gs^Fp       , Gg          , Ss          , Gg          , Gg          , Hh          , Hh          , Hh          , Hh          , Hh          , Chs         , Chs         , Chs         , Ss          , Ss          , Gg          
Ss          , Ss          , Ss^Vhs      , Gg          , Gg          , Gg          , Gg          , Gg          , Gg          , Gs^Fp       , Gs^Fp       , Gs^Fp       , Gs^Fp       , Gg          , Gg          , Ss          , Gg          , Hh          , Hh          , Hh          , Hh          , Hh          , Chs         , 4 Khs       , Chs         , Ss          , Gg          , Gg          
Ss          , Ss          , Ss          , Gg          , Gg          , Gg          , Gg          , Ss          , Ss          , Gg          , Gg          , Gs^Fp       , Ss          , Gg          , Gg          , Gg          , Gg^Vc       , Gs^Fp       , Hh          , Hh          , Hh          , Hh          , Ss          , Chs         , Ss          , Gg          , Gg          , Gg          
Ss          , Ss          , Ss          , Ss          , Ss          , Gg          , Gg          , Gg          , Gs^Fp       , Gs^Fp       , Gs^Fp       , Gg          , Gg          , Gg          , Gg          , Gg          , Gg          , Gg          , Gg          , Hh          , Gg          , Ss          , Gg          , Gg          , Ss          , Ss          , Ss          , Ss          
Ss          , Ww          , Ss          , Ss          , Ss          , Gg          , Gg          , Gs^Fp       , Gs^Fp       , Gg^Vc       , Gs^Fp       , Gs^Fp       , Gg          , Gg          , Ss          , Ss          , Hh          , Hh          , Hh          , Hh          , Gg          , Ss          , Gg          , Gg          , Ss          , Ss          , Ss          , Ss          
Ww          , Ww          , Ww          , Ww          , Ss          , Gg          , Gg          , Gg          , Gg          , Gs^Fp       , Gs^Fp       , Gg          , Gg          , Gg          , Ss          , Ss          , Hh          , Hh          , Hh          , Hh          , Gg          , Ss          , Gg          , Ss          , Ss          , Ss          , Ss          , Gs^Fp       
Ww          , Ww          , Ww          , Ww          , Ww          , Gg          , Gg          , Ss          , Ss          , Ss          , Ss          , Ss          , Gg          , Gg          , Gg          , Hh          , Hh          , Hh          , Hh          , Hh          , Gg          , Ss          , Ss          , Ss          , Chs         , Ss          , Ss          , Gs^Fp       
Ww          , Ww          , Ss          , Gs^Fp       , Ss          , Ww          , Ww          , Ss          , Ss          , Ss          , Ss          , Ss          , Gg          , Gg          , Gg          , Ss          , Ss          , Gg          , Hh          , Gg          , Gg          , Ss          , Ss          , Chs         , 5 Khs       , Chs         , Ss          , Gg          
Gg          , Gg          , Ss          , Ss          , Ss          , Ww          , Ss          , Ss          , Ss          , Ss          , Ss          , Ss          , Ss          , Gg          , Gg          , Gs^Fp       , Ss          , Ss          , Ss          , Ss          , Gg          , Ss^Vhs      , Ss          , Chs         , Chs         , Chs         , Ss          , Ss          
Ww          , Ww          , Ss^Vhs      , Ss          , Ss          , Ss          , Ss          , Ss          , Ss          , Ss          , Ss          , Ss          , Ss          , Ss          , Ss          , Gg          , Ss          , Ss          , Ss          , Ss          , Ss          , Gs^Fp       , Ss          , Ss          , Ss          , Ss          , Ss          , Ss          
Ss          , Ss          , Gg          , Ss          , Ss          , Ss          , Ss          , Ss          , Ss          , Ss          , Ss          , Ss          , Ss          , Ss          , Ss          , Gg          , Gg          , Ss          , Ss          , Ss          , Ss          , Ss          , Ss          , Ss          , Ss          , Ss          , Ss          , Ss          
Ss          , Ss          , Ss          , Ss          , Ss          , Ss          , Ss          , Gg          , Ss          , Ss          , Ss          , Ss^Vhs      , Ss          , Ss          , Ss^Vhs      , Ss          , Gg          , Gg          , Ss          , Ss          , Ss          , Ss          , Ss          , Ss          , Ss          , Ss          , Ss          , Ss          
Gg          , Ss          , Ss          , Ss          , Ss          , Ss          , Ce          , Gg          , Ss          , Ss          , Gg          , Ss          , Ss          , Ss          , Ss          , Ss          , Gg          , Gg          , Ss          , Gg          , Gg          , Gg          , Gg          , Ss          , Ss          , Ss          , Gg          , Gs^Fp       
Gg          , Ss          , Ss          , Ss          , Gg          , Ce          , 3 Ke        , Ce          , Ww          , Gg          , Ss          , Gg          , Gg          , Ss          , Gg          , Gg          , Gg          , Gs^Fp       , Ss          , Gg          , Gg          , Ss          , Ss          , Gg          , Gg          , Gs^Fp       , Gs^Fp       , Gs^Fp       
Gg          , Ss          , Ss          , Gg          , Gg          , Ce          , Ce          , Gg          , Ww          , Ss          , Ss          , Ss          , Ss          , Gg          , Gg          , Gg          , Gg          , Gs^Fp       , Ss          , Gg          , Gg          , Ss          , Gs^Fp       , Gs^Fp       , Gs^Fp       , Gs^Fp       , Gg          , Gg          
Ss          , Ss          , Ss          , Gg          , Gg          , Ww          , Ww          , Ww          , Ss          , Ss          , Ss          , Ss          , Hh          , Gg          , Gg          , Gg          , Gg          , Gg^Vc       , Ss          , Gg          , Gg          , Ss          , Gs^Fp       , Ss^Vhs      , Gs^Fp       , Gs^Fp       , Gg          , Gg          
Ss          , Ss          , Gg          , Gg          , Gg          , Ww          , Ss^Vhs      , Gg          , Ss          , Ss          , Ss          , Hh          , Ss          , Hh          , Gg          , Ss          , Ss          , Gs^Fp       , Ss          , Gg          , Gg          , Ss          , Gs^Fp       , Ss          , Ss          , Gs^Fp       , Gg          , Gg          
Gg          , Ss^Vhs      , Gg          , Ss          , Gg          , Ww          , Gg          , Ss          , Gg          , Gg          , Gg          , Ss          , Ss          , Ss          , Ss          , Hh          , Gs^Fp       , Re          , Ss          , Gg          , Gg          , Ss          , Ss          , Ss          , Ss          , Ss          , Ss          , Ss          
Gg          , Gg          , Gg          , Gg          , Gg          , Ww          , Ce          , Ss          , Ce          , Gg          , Ss^Vhs      , Ss          , Ss          , Ss          , Ss          , Ss          , Hh          , Re          , Ss          , Gg          , Gg          , Gg          , Gg          , Ss          , Ss          , Ss          , Ss          , Ss          
Gg          , Gg          , Gg          , Gg          , Gg          , Ww          , Ce          , 1 Ke        , Ce          , Gg          , Gg          , Ss          , Ss          , Ss          , Ss          , Ss          , Hh          , Re          , Ss          , Gg          , Gg          , Gg          , Gg          , Gg          , Ss          , Gs^Fp       , Ss          , Gg          
Gg          , Gg          , Gg          , Gg          , Ww          , Ww          , Gg          , Ce          , Gg          , Ss          , Ss          , Ss          , Ss          , Ss          , Ss          , Ss          , Hh          , Re          , Ss          , Gg          , Gg          , Gg          , Gg          , Gg          , Ss          , Ss          , Gg          , Gg          
Gg          , Gg          , Gg          , Ss          , Ww          , Gg          , Ss          , Ss          , Ww          , Ss          , 2 Ss        , Ss          , Ss          , Ss          , Ss          , Ss          , Hh          , Re          , Ss          , Gg          , Gg          , Gg          , Gg          , Gg          , Ss          , Ss          , Ss          , Aa          
Ss          , Ss          , Ss          , Ss          , Ww          , Ss^Vhs      , Ww          , Ww          , Ww          , Ss          , Ss          , Ss          , Ss          , Ss          , Ss          , Ss          , Gg          , Re          , Re          , Ss          , Ss          , Ss          , Ss          , Gg          , Ss          , Ss          , Ss          , Gg          
Gg          , Gg          , Gg          , Gg          , Gg          , Ww          , Ww          , Ww          , Ww          , Ww          , Ww          , Ss          , Ss          , Ss          , Hh          , Hh          , Gg          , Gg          , Gg          , Re          , Re          , Ss          , Ss          , Ss          , Ww          , Ww          , Ww          , Ss          
Gg          , Gg          , Gg          , Gg          , Gg          , Ss          , Ww          , Ww          , Ww          , Ww          , Ww          , Hh          , Hh          , Ss          , Ss          , Ss          , Ss          , Ss          , Gg          , Gg          , Gg          , Re          , Ss          , Ss          , Ss          , Ww          , Ww          , Ss          
