border_size=1
usage=map

Gg          , Gg          , Gg          , Gg          , Gg          , Gg          , Gg          , Aa          , Gg          , Gg          , Gs^Fp       , Gs^Fp       , Gg          , Gg          , Gg          , Gg          , Gg          , Gg          , Aa          , Aa          , Hh          , Hh          , Hh          , Hh          , Hh          , Hh          , Hh          , Hh          , Hh          , Hh          , Hh          , Gg          , Gs^Fp       , Gg          , Gg          , Gg          , Gg          , Aa          , Ha          , Hh          , Gg          , Gg          
Gg          , Aa          , Aa          , Aa          , Gg          , Gg          , Gg          , Aa          , Gg          , Gg          , Gs^Fp       , Gs^Fp       , Gg          , Gg          , Gg          , Gg          , Gg          , Hh          , Gg          , Aa          , Hh          , Hh          , Hh          , Hh          , Hh          , Hh          , Hh          , Hh          , Hh          , Hh          , Hh          , Gg          , Gs^Fp       , Gs^Fp       , Gg          , Gg          , Gg          , Gg          , Gg          , Gg          , Gg          , Gs^Fp       
Gg          , Aa          , Aa          , Aa          , Aa          , Aa          , Aa          , Aa          , Gg          , Gg          , Gs^Fp       , Gg^Ve       , Gs^Fp       , Gg          , Gg          , Gg          , Hh          , Hh          , Ha          , Ha          , Hh          , Hh          , Hh          , Hh          , Hh          , Hh          , Hh          , Hh          , Hh          , Hh          , Gg          , Gs^Fp       , Gs^Fp       , Gs^Fp       , Gs^Fp       , Gs^Fp       , Gg          , Gg          , Gg          , Gg          , Ww          , Gg          
Re          , Ds          , Ds          , Aa          , Aa          , Aa          , Aa          , Gg          , Gg          , Gg          , Re          , Re          , Re          , Gg          , Gg          , Gg          , Gg          , Hh          , Ha          , Ha          , Hh          , Hh          , Hh          , Hh          , Ch          , Ch          , Ch          , Hh          , Gg          , Gg          , Gs^Fp       , Gs^Fp       , Ss          , Gs^Fp       , Gg^Ve       , Gs^Fp       , Ww          , Ww          , Ww          , Ww          , Ww          , Gs^Fp       
Re          , Gg^Vh       , Gg          , Aa          , Aa          , Aa          , Aa          , Gg          , Re          , Re          , Gs^Fp       , Gs^Fp       , Gg^Vh       , Re          , Aa          , Aa          , Ha          , Ha          , Hh          , Aa          , Gg          , Hh          , Hh          , Hh          , Ch          , 2 Kh        , Ch          , Hh          , Gg          , Gg          , Gs^Fp       , Ss          , Gs^Fp       , Gs^Fp       , Gs^Fp       , Gs^Fp       , Ww          , Ww          , Ww          , Ww          , Ww          , Gs^Fp       
Ds          , Re          , Re          , Gg          , Aa          , Aa          , Re          , Re          , Gg^Vh       , Gs^Fp       , Ss          , Gs^Fp       , Gg          , Re          , Aa          , Aa          , Ha          , Hh          , Gg          , Gg          , Gg          , Gg          , Gg          , Gs^Fp       , Gs^Fp       , Ch          , Gs^Fp       , Gg^Ve       , Gs^Fp       , Gs^Fp       , Gs^Fp       , Ds          , Ds          , Ds          , Gg          , Ww          , Ww          , Ww          , Ww          , Ww          , Ww          , Ww          
Gs^Fp       , Gs^Fp       , Gg          , Re          , Aa          , Aa          , Aa          , Gg          , Gg          , Gs^Fp       , Ss          , Ss          , Gs^Fp       , Re          , Re          , Gg          , Hh          , Gg          , Gg          , Gg          , Gg          , Gg          , Gs^Fp       , Gs^Fp       , Gs^Fp       , Re          , Gs^Fp       , Gs^Fp       , Gs^Fp       , Gs^Fp       , Gs^Fp       , Ds          , Ds          , Ds          , Gg          , Ww          , Gg^Ve       , Ww          , Ww          , Ww          , Ww          , Ww          
Gs^Fp       , Gs^Fp       , Gg          , Gg          , Gg          , Gg          , Gg          , Gg          , Gs^Fp       , Gs^Fp       , Ss          , Gs^Fp       , Gs^Fp       , Gs^Fp       , Re          , Gg          , Re          , Re          , Re          , Re          , Re          , Gg          , Gs^Fp       , Gs^Fp       , Re          , Re          , Re          , Gg          , Gg          , Gs^Fp       , Ds          , Wo          , Wo          , Ww          , Ww          , Ww          , Gs^Fp       , Ww          , Ww          , Ww          , Ww          , Ww          
Gs^Fp       , Gs^Fp       , Gg          , Gg          , Gg          , Gg          , Gg          , Gg          , Gs^Fp       , Gs^Fp       , Gs^Fp       , Gs^Fp       , Gs^Fp       , Gs^Fp       , Gg^Ve       , Re          , Gg          , Gs^Fp       , Gs^Fp       , Gg          , Gs^Fp       , Re          , Re          , Re          , Gs^Fp       , Gs^Fp       , Re          , Gg          , Gg          , Gs^Fp       , Ds          , Wo          , Wo          , Ww          , Ww          , Ww          , Gg          , Ww          , Ww          , Ww          , Ww          , Ww          
Gs^Fp       , Gs^Fp       , Gs^Fp       , Gg          , Gg          , Gg          , Gg          , Gs^Fp       , Gg          , Ds          , Ds          , Ds          , Gs^Fp       , Gs^Fp       , Gs^Fp       , Gs^Fp       , Gs^Fp       , Gs^Fp       , Gs^Fp       , Gs^Fp       , Gg^Ve       , Gs^Fp       , Gs^Fp       , Gs^Fp       , Gg          , Gg          , Re          , Gs^Fp       , Gg^Ve       , Gs^Fp       , Ds          , Wo          , Wo          , Ds          , Ww          , Ww          , Ww          , Ww          , Ww          , Ww          , Ww          , Ww          
Gg          , Gs^Fp       , Gg          , Hh          , Gg          , Gg          , Gg          , Gg          , Ds          , Ds          , Ds          , Ds          , Ds          , Ss          , Gg          , Gg          , Gg          , Gs^Fp       , Gs^Fp       , Gs^Fp       , Gs^Fp       , Gs^Fp       , Gs^Fp       , Gs^Fp       , Gg          , Gg          , Re          , Gs^Fp       , Gg          , Gs^Fp       , Wo          , Wo          , Ds          , Ds          , Ww          , Ww          , Ww          , Ss          , Gs^Fp       , Gs^Fp       , Gs^Fp       , Ww          
Gg          , Gs^Fp       , Gs^Fp       , Gs^Fp       , Gs^Fp       , Gs^Fp       , Gs^Fp       , Gg          , Ds          , Ds          , Wo          , Wo          , Ds          , Ss          , Gg          , Gg          , Gg          , Gs^Fp       , Gs^Fp       , Gs^Fp       , Gs^Fp       , Gs^Fp       , Gs^Fp       , Gs^Fp       , Gs^Fp       , Gs^Fp       , Gs^Fp       , Re          , Gg          , Ds          , Ds          , Ds          , Gs^Fp       , Ds          , Ww          , Ww          , Ww          , Gs^Fp       , Ss          , Gs^Fp       , Gs^Fp       , Ww          
Gg          , Gg          , Gg          , Gs^Fp       , Gs^Fp       , Gg^Ve       , Gs^Fp       , Gg          , Ds          , Ds          , Wo          , Ds          , Ds          , Ss          , Gg          , Gs^Fp       , Gs^Fp       , Gs^Fp       , Gs^Fp       , Gg          , Gg          , Gs^Fp       , Gs^Fp       , Gs^Fp       , Gs^Fp       , Gs^Fp       , Gg          , Re          , Gg          , Gg          , Gg          , Gg          , Gg^Ve       , Ss          , Ss          , Ss          , Ss          , Gs^Fp       , Gs^Fp       , Gg          , Gg^Vh       , Ww          
Gg          , Gg          , Gg          , Gs^Fp       , Gg          , Gs^Fp       , Gs^Fp       , Ds          , Ds          , Ds          , Wo          , Ds          , Ds          , Gs^Fp       , Gs^Fp       , Gs^Fp       , Gs^Fp       , Gs^Fp       , Gg^Ve       , Gg          , Gg          , Gg          , Gs^Fp       , Gs^Fp       , Gs^Fp       , Gg          , Re          , Re          , Gg          , Gg          , Gg          , Gg          , Gs^Fp       , Gg          , Gg          , Gg          , Gs^Fp       , Gs^Fp       , Ss          , Ss          , Ss          , Ww          
Gg          , Aa          , Gg          , Gs^Fp       , Gs^Fp       , Ss          , Ds          , Ds          , Ds          , Wo          , Wo          , Ds          , Gs^Fp       , Gs^Fp       , Gg          , Gg          , Gs^Fp       , Gs^Fp       , Gs^Fp       , Gs^Fp       , Gg          , Gs^Fp       , Gs^Fp       , Gs^Fp       , Re          , Re          , Gg          , Gg          , Gg          , Gg          , Gg          , Gs^Fp       , Gs^Fp       , Gs^Fp       , Gs^Fp       , Gg          , Gs^Fp       , Ss          , Ss          , Ss          , Gg          , Ww          
Aa          , Gg          , Gg          , Gg          , Gg          , Gs^Fp       , Ds          , Ds          , Ds          , Wo          , Wo          , Ds          , Gg^Ve       , Gg          , Gg          , Gg          , Gg          , Gg          , Gg          , Gs^Fp       , Gs^Fp       , Gs^Fp       , Gs^Fp       , Gg          , Re          , Gg          , Gg          , Gg          , Gs^Fp       , Gs^Fp       , Gs^Fp       , Gs^Fp       , Gs^Fp       , Gs^Fp       , Gs^Fp       , Gs^Fp       , Gs^Fp       , Gs^Fp       , Ss          , Ss          , Ss          , Ds          
Aa          , Aa          , Gg          , Gg          , Gg          , Gg          , Ds          , Ds          , Ds          , Ds          , Ds          , Ss          , Gs^Fp       , Gg^Vh       , Gg          , Aa          , Aa          , Gg          , Gg          , Gg          , Gg          , Gs^Fp       , Gg          , Gs^Fp       , Re          , Gs^Fp       , Gg          , Gg          , Gs^Fp       , Gg^Ve       , Gs^Fp       , Gs^Fp       , Gs^Fp       , Gg          , Gg          , Gs^Fp       , Gs^Fp       , Gs^Fp       , Ss          , Ss          , Ds          , Ds          
Aa          , Gg          , Gg          , Gg          , Gg          , Gg          , Gs^Fp       , Gs^Fp       , Ds          , Ds          , Ds          , Ds          , Gs^Fp       , Gg          , Gg          , Gg          , Aa          , Gg          , Gg          , Gg          , Gg          , Gs^Fp       , Re          , Re          , Gs^Fp       , Gs^Fp       , Gs^Fp       , Gg          , Gg          , Gs^Fp       , Gs^Fp       , Gg^Ve       , Gs^Fp       , Gg          , Gg          , Gg          , Gg          , Gg          , Ss          , Gs^Fp       , Ss          , Ww          
Gg          , Gg          , Gg          , Gg          , Gg          , Gg          , Gg          , Gg^Vh       , Ds          , Ds          , Ds          , Ds          , Gs^Fp       , Gg          , Gg          , Gg          , Gg          , Gg          , Gg          , Gg          , Gg          , Re          , Gg          , Ss          , Gg          , Ss          , Ss          , Gg          , Gg          , Gg          , Gs^Fp       , Gs^Fp       , Gg          , Gg          , Gg          , Gg          , Gg          , Gg          , Gs^Fp       , Gs^Fp       , Gs^Fp       , Ww          
Gg          , Gg^Vh       , Gg          , Gg          , Gg          , Gg          , Gg          , Gg          , Ds          , Ds          , Ds          , Ds          , Gs^Fp       , Gg          , Gg          , Gg          , Gg          , Gg          , Gg          , Gg          , Gs^Fp       , Re          , Re          , Gg          , Gg          , Gg          , Ss          , Gs^Fp       , Gs^Fp       , Gs^Fp       , Gs^Fp       , Gg          , Gg          , Gg          , Aa          , Gg          , Gg          , Gs^Fp       , Gg^Ve       , Gs^Fp       , Ds          , Wo          
Gg          , Gg          , Gg          , Gg          , Gg          , Gg          , Gg          , Gg          , Ds          , Ds          , Ds          , Ds          , Gs^Fp       , Gs^Fp       , Gg          , Gg          , Gg          , Gg          , Gg          , Gg          , Gs^Fp       , Gg          , Re          , Gg          , Gg          , Ss          , Ss          , Gs^Fp       , Gs^Fp       , Gs^Fp       , Gg          , Gg          , Gg          , Gg          , Gg          , Gg          , Gg          , Gs^Fp       , Gs^Fp       , Gg          , Ds          , Wo          
Gg          , Gg          , Ds          , Ds          , Gg          , Gg          , Gg          , Ds          , Ds          , Ds          , Ds          , Ss          , Gs^Fp       , Gg          , Gs^Fp       , Gg          , Gg          , Gg          , Gs^Fp       , Gs^Fp       , Gs^Fp       , Gg          , Re          , Gg          , Gg          , Ss          , Ss          , Gs^Fp       , Gg^Ve       , Gs^Fp       , Gg          , Gg          , Gg          , Gg          , Gg          , Gg          , Gg          , Gg          , Ds          , Ds          , Gg          , Ds          
Ds          , Ds          , Ds          , Ds          , Ds          , Gg          , Ds          , Ds          , Ds          , Gg          , Gs^Fp       , Gs^Fp       , Gs^Fp       , Gg          , Gs^Fp       , Ss          , Gs^Fp       , Gs^Fp       , Gs^Fp       , Gg^Ve       , Gs^Fp       , Gg          , Re          , Gs^Fp       , Gs^Fp       , Gs^Fp       , Gs^Fp       , Gs^Fp       , Gs^Fp       , Gs^Fp       , Gg          , Gg          , Gg^Vh       , Hh          , Gg          , Gg          , Gg          , Gg          , Ds          , Ds          , Gg          , Gg          
Ds          , Ds          , Ds          , Ds          , Ds          , Ds          , Ds          , Ds          , Ds          , Gg          , Gg          , Gg          , Gg          , Gg          , Gs^Fp       , Ss          , Gs^Fp       , Gs^Fp       , Gs^Fp       , Gg          , Gs^Fp       , Hh          , Re          , Gg          , Gg          , Gg          , Gg          , Gg          , Gs^Fp       , Gs^Fp       , Gg          , Gg          , Hh          , Hh          , Hh          , Gg          , Gg          , Gg          , Gg          , Ds          , Gg          , Gg          
Wo          , Wo          , Wo          , Ds          , Ds          , Ds          , Ds          , Ds          , Ds          , Gg          , Gg^Vh       , Gg          , Gg          , Gg          , Gg          , Gs^Fp       , Gs^Fp       , Gs^Fp       , Gs^Fp       , Gs^Fp       , Gs^Fp       , Hh          , Hh          , Re          , Aa          , Gg          , Gg          , Gg          , Gg          , Gg          , Gg          , Gg          , Hh          , Hh          , Hh          , Gg          , Gg          , Gg          , Ds          , Ds          , Gg          , Gg          
Wo          , Wo          , Wo          , Wo          , Wo          , Wo          , Wo          , Wo          , Ds          , Gg          , Gg          , Gg          , Gg          , Gg          , Gs^Fp       , Gs^Fp       , Gs^Fp       , Gs^Fp       , Gs^Fp       , Gs^Fp       , Gs^Fp       , Gs^Fp       , Hh          , Re          , Gg          , Gg          , Aa          , Gg          , Gg          , Gg          , Gg          , Gg          , Hh          , Hh          , Gg          , Gs^Fp       , Gs^Fp       , Gs^Fp       , Gg          , Gg          , Aa          , Gg          
Wo          , Ds          , Ds          , Ds          , Ds          , Ds          , Wo          , Wo          , Ds          , Gs^Fp       , Gg          , Gg          , Gg          , Gg          , Gs^Fp       , Gg^Ve       , Gs^Fp       , Gs^Fp       , Gs^Fp       , Gg          , Gs^Fp       , Gg          , Hh          , Re          , Gs^Fp       , Gs^Fp       , Gg          , Gg          , Gg          , Gg          , Gg          , Gg          , Gg          , Gs^Fp       , Gs^Fp       , Gs^Fp       , Gs^Fp       , Gs^Fp       , Gg^Vh       , Gg          , Gg          , Gg          
Ds          , Gg          , Aa          , Aa          , Aa          , Ds          , Ds          , Ds          , Ds          , Gs^Fp       , Gg          , Gg          , Gs^Fp       , Gs^Fp       , Gs^Fp       , Gs^Fp       , Gs^Fp       , Gg          , Gg          , Gg          , Gs^Fp       , Gg          , Re          , Re          , Gg          , Gs^Fp       , Gg          , Gg          , Gg          , Gg          , Gg          , Gg          , Gg          , Gs^Fp       , Gs^Fp       , Gg          , Gs^Fp       , Gs^Fp       , Gs^Fp       , Gg          , Gg          , Gg          
Ds          , Gg          , Gg^Vh       , Gg          , Aa          , Gg          , Ds          , Ds          , Gs^Fp       , Gs^Fp       , Gg          , Gg          , Gs^Fp       , Gs^Fp       , Gs^Fp       , Gg          , Gg          , Gg          , Gg          , Gg^Vh       , Re          , Re          , Gg          , Ds          , Gg          , Gg^Vh       , Gs^Fp       , Gg          , Ds          , Gg          , Gg          , Gg          , Gg          , Gs^Fp       , Gs^Fp       , Gg          , Gg          , Gs^Fp       , Gs^Fp       , Gs^Fp       , Gg          , Gg          
Ds          , Ds          , Gg          , Gg          , Aa          , Gg          , Gg          , Gs^Fp       , Gs^Fp       , Gg          , Gg          , Gg          , Gs^Fp       , Gs^Fp       , Gs^Fp       , Gs^Fp       , Gg          , Gg          , Aa          , Re          , Gs^Fp       , Gg          , Gg          , Ds          , Gg          , Gg          , Gs^Fp       , Gg          , Ds          , Ds          , Gg          , Gg          , Gg          , Gg          , Gs^Fp       , Gs^Fp       , Gs^Fp       , Gs^Fp       , Gs^Fp       , Gs^Fp       , Gs^Fp       , Gs^Fp       
Ds          , Ds          , Gg          , Gg          , Gg          , Aa          , Gg          , Gg          , Gg          , Gg          , Gg          , Gs^Fp       , Gs^Fp       , Gs^Fp       , Gs^Fp       , Gs^Fp       , Gg          , Gg          , Gg          , Re          , Gs^Fp       , Gg          , Gg          , Gg          , Gg          , Ss          , Ds          , Ds          , Wo          , Ds          , Gg          , Gg          , Gg          , Gg          , Gg          , Gg          , Gg          , Gg          , Gs^Fp       , Gs^Fp       , Gs^Fp       , Gs^Fp       
Ds          , Gg          , Gg          , Gg          , Aa          , Aa          , Gg          , Gg          , Gs^Fp       , Gg          , Gs^Fp       , Gs^Fp       , Gs^Fp       , Gs^Fp       , Gg^Ve       , Gs^Fp       , Gg          , Gg          , Gg          , Re          , Gg          , Gs^Fp       , Gg          , Gg          , Gg          , Ss          , Gs^Fp       , Ds          , Wo          , Ds          , Gg          , Gg^Vh       , Gg          , Aa          , Aa          , Gg          , Gg          , Gg          , Gg          , Gs^Fp       , Gs^Fp       , Gs^Fp       
Wo          , Ds          , Gg          , Gg          , Aa          , Aa          , Gg          , Gg          , Gs^Fp       , Gs^Fp       , Gs^Fp       , Gs^Fp       , Gs^Fp       , Gs^Fp       , Gs^Fp       , Gs^Fp       , Gs^Fp       , Gs^Fp       , Gg          , Re          , Gg          , Gs^Fp       , Gs^Fp       , Gs^Fp       , Gs^Fp       , Ss          , Ds          , Ds          , Wo          , Ds          , Ds          , Gs^Fp       , Gg          , Gg          , Gg          , Gg          , Gg          , Gg          , Gg          , Gg          , Gg^Vh       , Gg          
Wo          , Ds          , Ds          , Gg^Vh       , Gg          , Aa          , Aa          , Gg          , Gs^Fp       , Gg          , Gs^Fp       , Gs^Fp       , Gg          , Gg          , Gg          , Gg          , Gs^Fp       , Gg          , Re          , Re          , Gg          , Gs^Fp       , Gs^Fp       , Gs^Fp       , Gs^Fp       , Ss          , Ds          , Ds          , Wo          , Wo          , Ds          , Ds          , Gs^Fp       , Gs^Fp       , Gs^Fp       , Gg          , Gg          , Ds          , Gg          , Gg          , Gg          , Gg          
Wo          , Ds          , Ds          , Gg          , Gg          , Aa          , Aa          , Gg          , Gg^Ve       , Gs^Fp       , Ss          , Gs^Fp       , Gg          , Gg          , Gg          , Gg          , Gg          , Gg          , Re          , Gg          , Gg          , Gg          , Gg          , Gs^Fp       , Ss          , Gg          , Ds          , Ds          , Wo          , Wo          , Wo          , Ds          , Ss          , Ss          , Gs^Fp       , Gg          , Gg          , Gg          , Ds          , Ds          , Ds          , Gg          
Wo          , Ds          , Ds          , Ds          , Gg          , Aa          , Aa          , Gg          , Gs^Fp       , Gs^Fp       , Ss          , Gs^Fp       , Gg          , Gg          , Gg          , Gg          , Gg          , Gg          , Re          , Gg          , Ds          , Gg          , Gg          , Gg          , Gs^Fp       , Ds          , Ds          , Ds          , Wo          , Wo          , Wo          , Ds          , Ds          , Ss          , Gs^Fp       , Gs^Fp       , Gg          , Ds          , Wo          , Wo          , Ds          , Gg          
Ds          , Ds          , Ds          , Ds          , Ds          , Gg          , Ds          , Ds          , Ds          , Ds          , Gs^Fp       , Gg          , Gg          , Gg          , Gg          , Gg          , Gg          , Gg          , Re          , Gg^Vh       , Gg          , Ds          , Gg          , Gs^Fp       , Ds          , Ds          , Ds          , Ds          , Wo          , Wo          , Ds          , Ss          , Gs^Fp       , Gs^Fp       , Gg^Ve       , Gs^Fp       , Gg          , Ds          , Wo          , Ds          , Ds          , Gg          
Ds          , Ds          , Ds          , Ds          , Ds          , Wo          , Ds          , Ds          , Ds          , Ds          , Gs^Fp       , Gs^Fp       , Gg          , Gg          , Gg          , Gg          , Gg          , Gg          , Gg          , Re          , Re          , Gg          , Gg          , Gs^Fp       , Gs^Fp       , Ds          , Ds          , Ds          , Wo          , Ds          , Gs^Fp       , Gs^Fp       , Gg          , Gs^Fp       , Gs^Fp       , Gg          , Gs^Fp       , Ds          , Ds          , Ds          , Aa          , Aa          
Gs^Fp       , Gs^Fp       , Gs^Fp       , Ds          , Ds          , Ds          , Ds          , Ds          , Ds          , Ds          , Ds          , Gg          , Gg          , Gg          , Gg          , Gg          , Gg          , Gg          , Aa          , Aa          , Aa          , Re          , Re          , Gg          , Gs^Fp       , Ss          , Ds          , Ds          , Ds          , Gs^Fp       , Gs^Fp       , Gg          , Ce          , Gg          , Gg          , Gg          , Gg          , Gg          , Ds          , Ds          , Gg          , Aa          
Gg          , Gg          , Gg^Vh       , Gs^Fp       , Gg          , Gg          , Gg          , Ds          , Ds          , Gg          , Gg          , Gg          , Gg          , Gg^Vh       , Gg          , Gg          , Gg          , Gg          , Aa          , Aa          , Aa          , Gg          , Gg          , Re          , Re          , Ds          , Wo          , Wo          , Ds          , Gg^Ve       , Gs^Fp       , Ce          , 1 Ke        , Ce          , Gg          , Gg          , Gg          , Gg          , Ds          , Ds          , Aa          , Aa          
Gg          , Gg          , Gg          , Gg          , Gg          , Gg          , Gg          , Gg          , Gg          , Gg          , Gg          , Aa          , Aa          , Gg          , Gg          , Gg          , Gg          , Gg          , Aa          , Aa          , Gg          , Gg          , Gg          , Gs^Fp       , Ss          , Re          , Wo          , Wo          , Ds          , Gs^Fp       , Gg          , Ce          , Ce          , Ce          , Gg          , Gg          , Gg          , Ds          , Ds          , Ds          , Gg          , Aa          
Gg          , Gg          , Gg          , Gg          , Gg          , Gg          , Gg          , Gg          , Gg          , Gg          , Gg          , Aa          , Aa          , Gg          , Gg          , Gg          , Gg          , Gg          , Aa          , Gg          , Gg          , Gg          , Gg          , Gs^Fp       , Ss          , Re          , Ds          , Ds          , Ds          , Gs^Fp       , Gg          , Gg          , Gg          , Gg          , Gg          , Gg          , Gg          , Ds          , Ds          , Ds          , Gg          , Gg          
